R 640 480


NO brick.xpm

SO dirt.xpm


EA stone.xpm

WE wood.xpm

S brice_sprite.xpm

C 106,176,76


F 83,92,104

11111111111111111
1011000100000000111
1000000000000000001
100000000S000000001
100000000000000000001
11111111111111111111
