R 33640 33480

NO ./pics/wall_n.xpm
SO ./pics/wall_s.xpm
WE ./pics/wall_w.xpm

EA ./pics/wall_e.xpm
S ./pics/sprite.xpm


C 106,176,76


F 83,92,104

		11111111111111111
1111111100000000111
1000200000000020001
100000000S000000001
10000000000000000001
11111111111111111111
