R 1920 1080


NO brick.xpm

SO dirt.xpm


EA stone.xpm

WE wood.xpm

S brice_sprite.xpm

C 106,176,76


F 83,92,104
11111111111111111111111111111111111111111111111111111111
11111111000000001111110000000001111001111111111111111101
10000000000111000110011001111111111001111111111111111101
12000000000111000110000001111111111000111111111111111101
100000000020000000000000000000000000001111111111111111001111111111
1000000000000000000000002000000000000000000000000000000000000000001
101111111111000000000000000000001111111111111111111111111111111111
101111000000111111110000000000001
10111100000011111111111111111111
1000000000001
10000000000001
100000000000001
1000000000000001
10000000000000001
100000000000000001
1000000000000000001
101111111111111111
1000000000000000001
10000000000000000001
100000000000000000001
10111111111111111111
100000000000000000001111111111111111111111111111111111111111111111111111111111
1000000000000000000000000000000000000000000200000000000000011
10000000000000000000000000000000000000000000000000000000001
1101111111111111111111111111111111111111111111111111111111
10N01
11111
