R 640 480

NO pics/wall_n.xpm
SO pics/wall_s.xpm
EA pics/wall_e.xpm
WE pics/wall_w.xpm

S pics/sprite.xpm

C 173,201,59
F 25,235,1

1111111
11020201
10020W011
1000200011
10200001
1111111
