R 1280 720

NO pics/wall_n.xpm
SO pics/wall_s.xpm
EA pics/wall_e.xpm
WE pics/wall_w.xpm

S pics/sprite.xpm

C 0,0,0
F 25,235,0

1111111
11020201
1000000111 
100020000N1
1020001111
1111111
