R 640 480

NO ./pics/wall_n.xpm
SO ./pics/wall_s.xpm
WE ./pics/wall_w.xpm
EA ./pics/wall_e.xpm

S ./pics/sprite.xpm

F 220,100,0
C 225,30,0

	111111111111
	1111000011
111100000001
10000000111
1000001001
1110000001
1000000001
1100000111
1000N00001
1111111111
