R	640 480
NO	./pics/path_to_the_north_texture
SO	./pics/path_to_the_south_texture
WE	./pics/path_to_the_west_texture
EA	./pics/path_to_the_east_texture

S	./path_to_the_sprite_texture
F	220, 100, 0
C	225, 30, 0


1111111111
1000000001
1010000001
1000000011
1000000001
1110000001
1000000001
1100000111
1000N00001
1111111111
