R 640 480

NO ./pics/wall_n.xpm
SO ./pics/wall_s.xpm
WE ./pics/wall_w.xpm
EA ./pics/wall_e.xpm

S ./pics/sprite.xpm

F 200,100,0
C 220,30,0

 11111
 10101
01N000
111110
